11111111111
10000P00001
10000000C01
10000000001
100E0100001
11111111111


