11111111111111111111111111111111111111111111111111111
100001P00000E0000000010000000000000000000000000000001
1000011111100000000C00CCCCCCCCCCCC0000000000000000001
10000000000000110000110000000000000000000000000000001
1CCCCCCCCCCCCCCCCCCC110000000000000000000000000000011
11111111111111111111111111111111111111111111111111111
