1111111111111111111111
1000000E00111110000001
1000000000000000000001
1111111110000000111111
1000P00C00000011000001
1111111111111111111111
